111111111
1P0000001
10E000001
100000C01
100100001
111111111