11111111111111111111
10000000000000000001
10E0000C000000000001
10000000000000000001
1000000000000E000001
1000000000000000P001
100P0000100000100001
10000001000000000001
10000010100000000001
10000010000000100001
10000000000000P10101
11111111111111111111