11111111111111111111
100000000000000000C1
10E000000000C0000001
10000000000000000001
10000000000000000001
10000000000000000001
10000000100000100001
10000001000000000001
1000001C100000000001
10000010000000000001
10000000000000P00101
11111111111111111111